10 5
2 2 2 2 2 1 1 1 1 1
2 2 2 2 2 1 1 1 6 1 
2 2 1 5 2 1 1 1 1 1
2 2 1 5 2 1 1 1 1 1
2 1 2 2 3 1 1 1 1 1

% 1 -> Empty
% 2 -> Wall
% 3 -> Goal
% 5 -> Box
% 6 -> Player
