10 5
1 1 1 1 1 1 1 1 1 1
1 1 1 1 1 1 2 1 6 1 
1 1 1 5 1 1 1 1 1 1
1 1 1 5 0 1 8 1 2 1
8 1 1 1 2 1 1 1 1 1

% 1 -> Empty
% 2 -> Wall
% 3 -> Goal
% 5 -> Box
% 6 -> Player
