10 10
2 2 2 2 2 2 2 2 2 2 
2 2 2 2 2 2 2 2 2 2 
2 2 1 1 3 1 1 2 2 2 
2 1 5 1 1 1 1 2 2 2 
2 1 2 5 3 1 2 2 2 2 
2 1 1 5 1 5 2 2 2 2 
2 2 1 3 6 1 1 3 2 2 
2 2 2 2 1 1 2 2 2 2 
2 2 2 2 2 2 2 2 2 2 
2 2 2 2 2 2 2 2 2 2


% 1 -> Empty
% 2 -> Wall
% 3 -> Goal
% 5 -> Box
% 6 -> Player
